17,37
1111111111111111111111111111111111111
1000000000000002000020020000000002001
1011110001000111110111110001020111101
1202000001010100022220210101020003001
1011110001210111111111110101111000101
1000000002010000000000002122220200101
1112201111010111101011110101111111101
1200002001212122201000012100000300001
1111111101012121111111210111000002001
1002020101210100002020010000000002001
1211113101010111111111110001111000101
1000000000000000000000000201020002101
1111111111111111111112001111000011131
0000000000000010000000100200000210001
0000000000000010311111111111020110201
0000000000000010000020020002010020001
0000000000000011111111111111111111111
1,1
