25,25
1111111111111111111111111
1000000000000000000020001
1011111111101011111111101
1010000020001000003000101
1010111111111111111112101
1012100000002000000010101
1210121111101011111010101
1010101000301000001010121
1010101011111111101010101
1212101010002000101010101
1210101010111110101010121
1010001000100010001000121
1111111111102000000001111
1010001000100010001000101
1010101012101110101010101
1010101010001000121010101
1010101011111311101010101
1012101000001010001210101
1010101111101210111010101
1010100020021210000010101
1010111111111011111110101
1210200000001210020000101
1011111111101011111111101
1000000200001010000020001
1111111111111111111111111
1,1