25,25
1111111111111111111111111
1000000000000000000000001
1011111111101011111111101
1010000000001000003000101
1010111111111111111110101
1010100000000000000010101
1010101111101011111010101
1010101000001000001010101
1010101011111111101010101
1010101010000000101010101
1010101010111110101010101
1010001000100010001000101
1111111111102000000001111
1010001000100010001000101
1010101010101110101010101
1010101010001000101010101
1010101011111311101010101
1010101000001010001010101
1010101111101010111010101
1010100000001010000010101
1010111111111011111110101
1010000000001010000000101
1011111111101011111111101
1000000000001010000000001
1111111111111111111111111
1,1