12,37
0000000000001101111111111111111111111
0000000000010010000000000110000000000
0000000000100001000000000101000000000
0000000001000001000000200100100000000
0000000010000000100000000100010000000
0000000100000000010000000100001000000
0000000111111111100000000100000100000
0000010000000000000100000100000010000
0000100000000000000010000100000001000
0001000000003000000001000100000000100
0010000000000000000000100100000000010
0100000000000000000000010100000000001
1,1