23,33
111111111111111111111111111111111
100000000000000000000000000000001
100111100111110010011111001111001
100100100111110010011111001001001  
100111100111110010011111001111001
100000000000000000000000000000001
100000000000000000000000000000001
100111100100011111110001001111001
100000000100000010000001000000001
100000000100000010000001000000001
111111100111110010011111001111111
000000100100000000000001001000000
000000100100000000000001001000000
111111100111110010011111001111111
100000000000000010000000000000001
100000000000000010000000000000001
100000000000000010000000000000001
111000100100011111110001001000111
100000000100000010000001000000001
100000000100000010000001000000001
100111111111110010011111111111101
100000000000000000000000200000001
111111111111111111111111111111111
1,1