17,37
1111111111111111111111111111111111111
1000000000000000000000000000000000001
1011110001000111111111110001000111101
1000000001000100000000010001000000001
1011110001000111111111110001111000101
1000000000000000000000000000000000101
1110001111000111101011110001111111101
1000000001000100001000010000000000001
1111111101000101111111010000000000001
1000000101000100002000010000000000001
1011110101000111111111110001111000101
1000000000000000000000000001000000101
1111111111111111111110001111000011101
0000000000000010000000100000000010001
0000000000000010011111111111000010001
0000000000000010000000000000000000001
0000000000000011111111111111111111111
1,1









