13,26
11111111011111111111111111
10000000010000010000000001
10111111110011110111111101
10000000000000000100000001
10111111101111111100001111
10100000101001000100000001
10111100101001010100000001
10000000101001010101111001
11111111101000010100001001
10000000101000010100001001
10100011101111110111111001
10102000000000000000000001
11111111111111111111111111
1,2