22,27
111111111111111111111111111
100000000000000000000000001
101111110010010000011111101
101000000010010000000000101
101001110010010011100100101
101001110010010011100100101
101001110010010011100100101
100000000000010000000100001
101111111110010011111100001
100000000000000000000000001
101110010011111110011111101
100000010011111110010000001
100000010011111110010000001
101111110011111110010011101
100000000000000000000000001
100001111110010011111111101
100001000000010000000000001
101111001110010010011111101
101201001110010010011100101
101001001110010010011100101
101000000000010010000000101
111111111111111111111111111
1,1
