21,21
111111111111111111111
100000001000100000001
101111111010111011111
100000000010000010001
101110111111101110111
100010001003000000001
111011111111111110111
101010001000100000001
101110111311101011101
100010000000001010001
101010111011111110001
101000001000100000001
101111111110101111101
100010100000100000101
111110101110101111101
100010001000300010101
101010111111111010111
101010000000000010001
101111111010111011101
100000000210001000001
111111111111111111111
1,1
