19,19
1111111111111111111
1222222200100300021
1001101011111011101
0000001200122010001
1120111110101111101
1000020010021222201
1011111011111011101
1000101020100200121
1010101110101110101
1210122212222222101
1110111011111111111
1000102222223010001
1010101110101111011
1012101000100000001
1011121101101111101
1222221002020010021
1110111011131111101
1022222010002002001
1111111111111111111
2,2