13,26
11111111011111111111111111
10000222212320010020220301
10111111112011110111111101
10220002020222200100020001
10111111101111111100101111
10102000121001003101102001
10111102101201010102102201
10220200101001010101111201
11111111102202010100201001
10000200101022010102001001
10100011121111110111111001
10102022222020022002000301
11111111111111111111111111
1,2