24,47
00000000000100100100000002000100100100000000000
00000000001001001001111111110010010010000000000
00000000010010010010000000001001001201000000000
00000000120100120100111111100100100100100000000
00000001001001001001000000010010010010010000000
00000010012010010010011111021001001001001000000
00000100100102100100100300100100100100100100000
00001000031001001000001010010010010010010010000
00011111010010011111110001001001001001201001000
00000000000000002000000120100100100100100100100
01100111111111111111111010010010010210010010010
12000000300100000000200000001001001001001001001
10001111010010011111110001001021001001001001201
01000001001001001000001010010010010010010010010
00100100100100100120100100100100100100100100100
00012010010010010010010001001001001001001001000
00001001001001021001001110010010010010210010000
00000102100100100100100200102100100100100100000
00000010010010010010011111001001001001001000000
00000001201001001001002000010010010010210000000
00000000100100100100111111100100102100100000000
00000000010010010010020000000001001001000000000
00000000001001001001111111110010010010000000000
00000000000100100100000000000100100100000000000
1,1